"debugmode b=Activate debugmode，b is true or false.
message m=Put a message on screen.
largemessage m m=Put a large message. First m will be large, the second m is small.
place x y z i=Put block at position x, y, z. 
places keyword value=Click for more information. 
replace x1 y1 z1 to x2 y2 z2 i1 i2=Replace the blockID i1 to i2 within (x1, y1, z1) to (x2, y2, z2).
dig x y z=Dig a hole (x, y, z) in size.
digs x1 y1 z1 to x2 y2 z2 i=Within (x, y, z) dig up blockID i. 
addentity x y z n=Add an entity，n is the entityID.
removenpc value=Kick player. Click for more information.
kill n=Kill entity，n is entityID.
heal n v=heal entity, n is entityID.
injure n v=hurt (n is entityID)
catchfire value v=set block on fire. Click for more information.
shapeshifter b=turn to Wolfman，b is true or false.
invulnerable b=Godmode enable. 
adddrops x y z i c=Add drops of blockID i at (x, y, z)，c is amount.
removedrops value=Kill all drops. Click for more information. 
launchdrops x y z i v1,v2,v3=Launch drops of blockID i from (x, y, z)，with speed (v1,v2,v3).
tp x y z=Teleport to (x, y, z).
spawn x y z=Set spawnpoint in world. 
boxstage t=Player Hit box，t = [1, 5]. 
playerstats keyword value=Change playerstats. Click for more information. 
playeraction keyword value=Change playeraction. Click for more information. 
playerinput keyword=Change playerinput. Click for more information. 
additems s i c=Add c amount of ID i to your inventory，s is grid number. 
removeitems value=Remove items from inventory. Click for more information. 
addchestitems x y z s i c=Add items to chest at (x, y, z), c amount of ID i, s is grid no. 
removechestitems value=Remove items from chest. Click for more information. 
openchest x y z=Open chest at (x, y, z).
openfurnace x y z=Open furnace at (x, y, z).
opendispenser x y z=Open dispenser at (x, y, z).
opentable x y z=Open table at (x, y, z).
widget keyword=Activate widget. Click for more information. 
clickbutton x y z=Activate the button at (x, y, z). 
explosion x y z v=Make an explosion at (x, y, z). With barrel vol v. 
lightning x y z=Summon lightning to (x, y, z). 
rain b=Enable rain or snow，b is true or false.
temperature x1 y1 z1 to x2 y2 z2 v=Put a region between (x1, y1, z1) and (x2, y2, z2) at temperature v. 
humidity x1 y1 z1 to x2 y2 z2 v=Put a region between (x1, y1, z1) and (x2, y2, z2) at humidity v
copy x1 y1 z1 to x2 y2 z2 /paste x3 y3 z3 to x4 y4 z4 value=copy one region to another.
moveblock x1 y1 z1 to x2 y2 z2 v1,v2,v3 value=让选中区域的方块运动，向量(v1,v2,v3)控制方向与路程
moveset keyword n value=运动方块设计玩法
hammer x y z value=一键敲家具，t为敲击面，取1至4整数
unhammer x y z s=以(x,y,z)为生成起始点还原家具大模型，s为家具序号
replacedesign x1 y1 z1 to x2 y2 z2 i1 i2=替换区域内的家具搭建方块
linkdesign value=将多个家具拼合为多态家具
write m=将内容写入Survivalcraft2.2/Command目录的command.txt文件
writeappend m=以文本追加的形式将内容写在command.txt文件后面
read c=读取command.txt文件的第c行并显示在屏幕
copefile f=将Command目录中指定的文件复制到存档目录
getcell x1 y1 z1 to x2 y2 z2=获取一个区域的方块信息并写入Command目录下的cell.txt文件
getid v=由方块完整值v获取id与特殊值
getterrain x y z=获取地形相关信息并显示在屏幕
getplayerstats=获取玩家当前属性的数据
world f=切换世界，f为世界名
worldtexture f=更换世界材质，f为存档或Command目录中的材质名
audio f v=f为存档或Command目录下的音频文件名，v为音量，取0至15
image x y z f value=在起始点(x,y,z)生成像素图，f为上述目录中的图片名
pattern x y z f t v=在点(x,y,z)生成贴图，f同上为图片名，t取1到6整数，v为图片大小
removepattern x1 y1 z1 to x2 y2 z2=移除区域内的光点贴图
build x y z f=读取上述目录中名为f的方块文件，在起始点(x,y,z)生成建筑
model n f=更换动物模型，n为实体名，f为上述目录pak文件中模型的路径名
modeltexture n f=更换指定动物的材质，n为动物实体名，f为上述目录中的材质名
modelsize n v=更改模型大小，v取10为原比例大小
gamemode t=切换游戏模式，t取0到4整数
changetime t=切换时间，t为1到4整数
capturephoto=一键截图
web w=打开网站，w为网址
settings keyword value=更改游戏设置
blockdata keyword i value=方块属性动态修改，i为方块id
clothesdata keyword s value=衣物属性动态修改，s为衣物序号
creaturedata keyword n value=生物属性动态修改，n为动物名
exit=退出游戏

place? x y z i=方块存在判定
places? x1 y1 z1 to x2 y2 z2 i=区域内方块存在判定
dig? i=挖掘方块判定
blockchange? x y z=方块变化判定
dropsexist? x1 y1 z1 to x2 y2 z2 i=区域内掉落物存在判定
entityexist? x1 y1 z1 to x2 y2 z2 n=区域内生物实体存在判定
itemsexist? value=主角背包物品存在判定
chestitemsexist? x y z value=箱子物品存在判定
handitemsexist? i value=手持方块判定
playerstats? keyword v1 to v2=玩家属性判定
playeraction? keyword=玩家动作判定
playerinput? keyword=玩家输入判定
playerheight? y1 to y2=玩家位置高度判定
eyesangle? x1 to y1 and x2 to y2=玩家视角判定
widget? keyword=界面判定
gamemode? t=游戏模式判定，t取0至4整数"
<SubinstructionList: When you click on some instructions> 
places cube x1 y1 z1 to x2 y2 z2 i=两点确定区域，生成长方体
places line x1 y1 z1 to x2 y2 z2 i=两点连线
places sphere x y z r i=生成球，r为半径
places column x y z h r t i=生成圆柱，t表示坐标方向，取1至3整数
places cone x y z h r t i=生成圆锥，h为高，取负值反向生成
copy x1 y1 z1 to x2 y2 z2 /paste x3 y3 z3 to x4 y4 z4=选择两个长宽高相等的长方体区域并进行复制粘贴
copy x1 y1 z1 to x2 y2 z2 /paste x3 y3 z3 to x4 y4 z4 /airapply=带空气方块复制粘贴
copy x1 y1 z1 to x2 y2 z2 /paste x3 y3 z3 to x4 y4 z4 /shear=剪切复制，将区域1移动到区域2
removenpc=移除视距内所有非玩家生物
removenpc Boat=移除实体船
removenpc n=移除指定的生物，n为动物名
removedrops=移除所有掉落物
removedrops i=移除指定的掉落物
removeitems=移除玩家背包的所有物品
removeitems s=移除玩家背包中指定格的物品
removeitems s c=移除玩家背包中指定数量的物品，c为数量
removechestitems x y z=移除箱子中的所有物品
removechestitems x y z s=移除箱子中指定格的物品
removechestitems x y z s c=移除箱子中指定数量的物品，c为数量
catchfire n v=使实体着火，v为着火的持续时间
catchfire x y z v=使方块着火，v为着火的扩散强度
moveblock x1 y1 z1 to x2 y2 z2 v1,v2,v3=以默认方式让方块运动
moveblock x1 y1 z1 to x2 y2 z2 v1,v2,v3 r=以穿透方式让方块运动，r为速率
moveblock x1 y1 z1 to x2 y2 z2 v1,v2,v3 r /limit=运动方块碰到其他方块时会停止
moveblock x1 y1 z1 to x2 y2 z2 v1,v2,v3 r /dig=运动方块碰到其他方块时会撞掉
moveset add n x1 y1 z1 to x2 y2 z2=添加标签名为n的运动方块设计，两点选中的区域为设计主体
moveset move n v1,v2,v3 r=让标签名为n的运动方块设计移动
moveset stop n=让标签名为n的运动方块设计停下
moveset remove n=移除标签名为n的运动方块设计
hammer x y z=以默认方式一键敲家具
hammer x y z t=选择不同方向敲家具，t为敲击面，取1至4整数
hammer x y z t /edit=以打开设计界面的方式敲家具
linkdesign s1,s2,s3...=将多个家具拼合为普通多态家具
linkdesign s1,s2,s3... /wire=将多个家具拼合为联动多态家具
image x y z f=在XOY平面生成像素图，默认方式
image x y z f /tile=在XOZ平面生成像素图，平铺方式
image x y z f /rotate=在YOZ平面生成像素图，侧转方式
widget clothing=打开玩家衣服界面
widget stats=打开玩家数据界面
widget inventory=打开玩家背包界面
widget none=关闭所有界面
settings visibility v=设置视距大小
settings brightness v=设置黑暗区域亮度
settings skyrendering t=切换天空渲染模式，t取1至3整数
settings soundvolume v=设置游戏音量
settings musicvolume v=设置背景音乐音量
settings movesensitivity v=设置移动灵敏度
settings looksensitivity v=设置观看灵敏度
playerstats level v=设置玩家等级
playerstats health v=设置玩家生命值
playerstats hunger v=设置玩家饥饿度
playerstats endurance v=设置玩家耐力值
playerstats fatigue v=设置玩家疲劳度
playerstats attack v=设置玩家攻击力
playerstats defense v=设置玩家防御值
playerstats speed v=设置玩家速度
playerstats temperature v=设置玩家体温
playerstats wetness v=设置玩家体湿
playeraction jump v=玩家跳跃控制
playeraction fly b=创造模式控制玩家飞行状态，b取true或false
playeraction dig b=创造模式设置玩家是否可挖掘方块，b取true或false
playeraction rider b=控制玩家骑行，b为true则上马，为false则下马
playeraction sneak b=控制玩家潜行状态
playeraction look v1,v2=改变玩家观看角度，向量(v1,v2)控制方向与转速
playeraction move v1,v2=改变玩家移动位置，向量(v1,v2)控制方向与移速
playeraction sleep b=控制玩家睡觉，b为false则醒来
playeraction stiff b=定住玩家，b为true则定住，为false则解除
playeraction lock b=锁定屏幕，b为true则屏幕不可滑动，为false则解除
playeraction waterbreathe b=改变玩家水下呼吸状态，b为true则可长久呼吸
playeraction cough b=玩家咳嗽控制
playeraction sneeze b=玩家打喷嚏控制
playeraction hasflu b=玩家感冒控制
playeraction sick b=玩家呕吐控制
playerinput moveup v=向前进v个单位
playerinput movedown v=向后退v个单位
playerinput moveleft v=向左移v个单位
playerinput moveright v=向右移v个单位
playerinput lookup v=向上滑动v个单位
playerinput lookdown v=向下滑动v个单位
playerinput lookleft v=向左滑动v个单位
playerinput lookright v=向右滑动v个单位
blockdata DefaultIconBlockOffset i v1,v2,v3=默认图标块偏移
blockdata DefaultIconViewOffset i v1,v2,v3=默认图标视图偏移
blockdata FirstPersonOffset i v1,v2,v3=第一人称偏移
blockdata FirstPersonRotation i v1,v2,v3=第一人称旋转
blockdata InHandOffset i v1,v2,v3=手持偏移
blockdata InHandRotation i v1,v2,v3=手持旋转
blockdata DefaultIconViewScale i v=默认图标视图缩放
blockdata FirstPersonScale i v=第一人称缩放
blockdata InHandScale i v=手持缩放
blockdata DefaultShadowStrength i v=默认阴影强度
blockdata LightAttenuation i v=光衰减强度
blockdata DefaultEmittedLightAmount i v=默认发光强度
blockdata ObjectShadowStrength i v=物体阴影强度
blockdata DefaultDropContent i v=默认掉落内容
blockdata DefaultDropCount i v=默认掉落数量
blockdata DefaultExperienceCount i v=默认掉落经验
blockdata RequiredToolLevel i v=所需工具级别
blockdata MaxStacking i v=最大堆积
blockdata SleepSuitability i v=适合睡眠
blockdata FrictionFactor i v=摩擦系数
blockdata Density i v=密度
blockdata Durability i v=耐久
blockdata FuelHeatLevel i v=燃料加热水平
blockdata FuelFireDuration i v=燃料持续时间
blockdata ShovelPower i v=铲子效率
blockdata QuarryPower i v=稿子效率
blockdata HackPower i v=斧子效率
blockdata DefaultMeleePower i v=默认近战攻击力
blockdata DefaultMeleeHitProbability i v=默认近战命中概率
blockdata DefaultProjectilePower i v=默认射击攻击力
blockdata ToolLevel i v=工具等级
blockdata PlayerLevelRequired i v=需要玩家等级
blockdata ProjectileSpeed i v=投掷速度
blockdata ProjectileDamping i v=投掷阻力
blockdata ProjectileTipOffset i v=投掷倾摆
blockdata ProjectileStickProbability i v=投掷粘上概率
blockdata DefaultHeat i v=默认热量
blockdata FireDuration i v=燃烧持续时间
blockdata ExplosionResilience i v=爆炸抗性
blockdata DefaultExplosionPressure i v=默认爆炸压力
blockdata DigResilience i v=挖掘抗性
blockdata ProjectileResilience i v=投掷弹性
blockdata DefaultSicknessProbability i v=默认患病概率
blockdata DefaultRotPeriod i v=默认旋转周期
blockdata DefaultTextureSlot i v=默认纹理位置
blockdata IsCollidable i b=是否可碰撞
blockdata IsPlaceable i b=是否可放置
blockdata IsDiggingTransparent i b=挖掘是否透明
blockdata IsPlacementTransparent i b=放置是否透明
blockdata DefaultIsInteractive i b=是否可交互
blockdata IsEditable i b=是否可编辑
blockdata IsNonDuplicable i b=是否可堆叠
blockdata IsGatherable i b=是否可收集
blockdata HasCollisionBehavior i b=是否有碰撞行为
blockdata KillsWhenStuck i b=卡住是否会死亡
blockdata IsFluidBlocker i b=是否为流体方块
blockdata IsTransparent i b=是否透明
blockdata IsAimable i b=是否可瞄准
blockdata IsStickable i b=是否可粘贴
blockdata AlignToVelocity i b=与速度对齐
blockdata NoAutoJump i b=禁止自动跳跃
blockdata NoSmoothRise i b=非平稳上升
blockdata DisintegratesOnHit i b=击中后消失
blockdata DefaultExplosionIncendiary i b=默认爆炸燃烧弹
blockdata IsExplosionTransparent i b=爆炸透明
blockdata Behaviors i Throwable=抛掷行为
blockdata Behaviors i Wood=树木行为
blockdata Behaviors i Ivy=常春藤行为
blockdata Behaviors i Rot=腐烂行为
blockdata Behaviors i BottomSucker=底部吸盘行为
blockdata Behaviors i WaterPlant=水生植物行为
blockdata Behaviors i FenceI=栏杆行为
blockdata Behaviors i ImpactExplosives=爆炸物冲击行为
blockdata Behaviors i Explosives=爆炸物行为
blockdata Behaviors i Carpet=地毯行为
blockdata Behaviors i Campfile=篝火行为
blockdata Behaviors i Furniture=家具行为
blockdata Behaviors i Egg=蛋行为
blockdata Behaviors i Bullet=子弹行为
blockdata Behaviors i Fertilizer=肥料行为
blockdata Behaviors i Hammer=锤子行为
blockdata Behaviors i Bow=弓行为
blockdata Behaviors i Crossbow=弩行为
blockdata Behaviors i Musket=火枪行为
blockdata Behaviors i Arrow=箭行为
blockdata Behaviors i Bomb=炸弹行为
blockdata Behaviors i Fireworks=烟花行为
blockdata Behaviors i PistonI=活塞行为
blockdata Behaviors i Grave=墓碑行为
blockdata Behaviors i Soil=土壤行为
blockdata Behaviors i Saddle=马鞍行为
blockdata Behaviors i Match=火柴行为
blockdata Behaviors i Bucket=铲行为
blockdata Behaviors i Cactus=仙人掌行为
blockdata Foodtype i Bread=面包食物类
blockdata Foodtype i Fish=鱼食物类
blockdata Foodtype i Fruit=水果食物类
blockdata Foodtype i Grass=草食物类
blockdata Foodtype i Meat=肉食物类
blockdata Foodtype i None=非食物类
clothesdata ArmorProtection s v=修改护甲值
clothesdata Sturdiness s v=修改耐久度
clothesdata Insulation s v=修改保暖度
clothesdata MovementSpeedFactor s v=修改步行速度增幅程度
clothesdata SteedMovementSpeedFactor s v=修改骑行速度增幅程度
clothesdata DensityModifier s v=修改最外层密度增幅程度
clothesdata Layer s v=修改层级
clothesdata PlayerLevelRequired s v=修改玩家等级需求
clothesdata IsOuter s b=是否最外层
clothesdata CanBeDyed s b=是否可染色
creaturedata Mass n v=修改质量
creaturedata Density n v=修改密度
creaturedata BoxSize n v1,v2,v3=修改碰撞箱
creaturedata Velocity n v1,v2,v3=修改移动位置
creaturedata LookOrder n v1,v2=转头控制
creaturedata TurnOrder n v1,v2=转身控制
creaturedata AirDrag n v1,v2=修改空气阻力
creaturedata WaterDrag n v1,v2=修改水阻力
creaturedata AirCapacity n v=修改空气量
creaturedata Health n v=修改生命值
creaturedata AttackPower n v=修改攻击力
creaturedata AttackResilience n v=修改攻击抗性
creaturedata FallResilience n v=修改摔倒抗性
creaturedata CorpseDuration n v=修改尸体持续时间
creaturedata StunTime n v=修改眩晕时间
creaturedata JumpOrder n v=跳跃控制
creaturedata JumpSpeed n v=修改跳跃速度
creaturedata SwimSpeed n v=修改游泳速度
creaturedata TurnSpeed n v=修改转身速度
creaturedata WalkSpeed n v=修改行走速度
creaturedata IsInvulnerable n b=是否无懈可击
creaturedata IsCreativeFlyEnabled n b=是否创造可飞行
creaturedata Action n head,v1,v2=人模型头部动作
creaturedata Action n hand1,v1,v2=人模型左手动作
creaturedata Action n hand2,v1,v2=人模型右手动作
creaturedata Action n leg1,v1,v2=人模型左脚动作
creaturedata Action n leg2,v1,v2=人模型右脚动作
creaturedata Action n head,v=两脚或四脚动物模型头部动作
creaturedata Action n leg1,v=两脚或四脚动物模型左(前)脚动作
creaturedata Action n leg2,v=两脚或四脚动物模型右(前)脚动作
creaturedata Action n leg3,v=四脚动物模型左(后)脚动作
creaturedata Action n leg4,v=四脚动物模型右(后)脚动作
creaturedata Sound n f=更换声音，f为Content/Audio/Creatures下的动物声音文件夹名
creaturedata Behaviors n remove,all=移除所有行为
creaturedata Behaviors n remove,behaviorname=移除一种动物行为
creaturedata Behaviors n add,behaviorname=添加一种动物行为

itemsexist? i=主角背包是否存在物品i
itemsexist? s i c=主角背包第s格是否存在数量为c的物品i
chestitemsexist? x y z i=指定箱子是否存在物品i
chestitemsexist? x y z s i c=指定箱子第s格是否存在数量为c的物品i
handitemsexist? i=是否手持方块i
handitemsexist? i c=是否手持数量为c的方块i
playerstats? level v1 to v2=玩家等级是否在指定范围内
playerstats? health v1 to v2=玩家生命值是否在指定范围内
playerstats? hunger v1 to v2=玩家饥饿度是否在指定范围内
playerstats? endurance v1 to v2=玩家耐力值是否在指定范围内
playerstats? fatigue v1 to v2=玩家疲劳度是否在指定范围内
playerstats? attack v1 to v2=玩家攻击力是否在指定范围内
playerstats? defense v1 to v2=玩家防御值是否在指定范围内
playerstats? speed v1 to v2=玩家行走速度是否在指定范围内
playerstats? temperature v1 to v2=玩家体温是否在指定范围内
playerstats? wetness v1 to v2=玩家体湿是否在指定范围内
playeraction? fly=玩家飞行判定
playeraction? fall=玩家下落判定
playeraction? climb=玩家攀爬判定
playeraction? swim=玩家游泳判定
playeraction? sneak=玩家潜行判定
playeraction? rider=玩家骑行判定
playeraction? walk=玩家行走判定
playeraction? move=玩家运动判定
playeraction? sleep=玩家睡觉判定
playeraction? jump=玩家跳跃判定
playeraction? aim=玩家瞄准判定
playeraction? hit=玩家击打判定
playeraction? interact=玩家交互判定
playeraction? hasflu=玩家感冒判定
playeraction? sick=玩家呕吐判定
playerinput? moveup=是否点击向上键
playerinput? movedown=是否点击向下键
playerinput? moveleft=是否点击向左键
playerinput? moveright=是否点击向右键
playerinput? lookup=是否上滑屏幕
playerinput? lookdown=是否下滑屏幕
playerinput? lookleft=是否左滑屏幕
playerinput? lookright=是否右滑屏幕
widget? chest=是否为箱子界面
widget? dispenser=是否为发生器界面
widget? furnace=是否为熔炉界面
widget? table=是否为工作台界面
widget? clothing=是否为玩家衣服界面
widget? stats=是否为玩家数据界面
widget? inventory=是否为玩家背包界面
widget? none=是否没有打开任何界面